
NO ./textures/wall_4.xpm
SO ./textures/wall_4.xpm
EA ./textures/wall_4.xpm
WE ./textures/wall_4.xpm

C 155,100,160
F 111,111,111

111111
1  111
110111
111111
1N1111
111111
