
NO ./textures/wall_4.xpm
SO ./textures/wall_4.xpm
EA ./textures/wall_4.xpm
WE ./textures/wall_4.xpm

C 155,100,160
F 111,111,111

       1
11111110111111111
1000000000N000001
10100000100000101
10000000000000001
10001000100010001
10000000000000001
10101010001010101
10000000000000001
10001000100100001
10000000000000001
10100000100001001
10000000000000001
11110111111111111
  1
