NO ./textures/bear.xpm
SO ./textures/deer.xpm
WE ./textures/forest.xpm
EA ./textures/stag.xpm

F 91,114,60
C 91,146,229

1111111111111111
1000000000000001
1010000000000001
10000N0000000001
1000000000000001
1000000000000001
1000000000000001
1000000000000001
1000000000000001
1000000000000001
1000001111000001
1111111111111111