  NO ./textures/bear.xpm
SO ./textures/deer.xpm
WE ./textures/forest.xpm

EA ./textures/stag.xpm

F 3   , 252    , 24     
C 225,30,0

        1111111111111111111111111
        1000000000110000000000001
        1011000001110111000000001
        10010000000001 1000000001
111111111011000001110111000000001
100000000011000001110111111111111
11110111111111011100000010001
11110111111111011101010010001
11000000110101011100000010001
10000000000000001100000010001
1000000000000N001101010010001
110000011101010111110111100111
11110111 1110101 101111010001
11111111 1111111 111111111111
1111
1001
1111