  NO ./textures/semi_crafted_stone_wall.xpm
SO ./textures/league_wall.xpm
WE ./textures/dirt_stone.xpm
EA ./textures/stone_wall.xpm

F 205,250,250
C 250,250,250

1111111111111111111111111111111111111111111111111111111111111111111111111111111111111111111111111111111111111111111111
11S0000000000111111111111111111111111111111111111111111111111111111111111111111111111111000000000011111111111111111111
11000000100000011111111111111111111111111111111111111111111100000000000000000000000000000000000000011111111111111111111
1101111111100000111111111111111111111111111111111111111111100000000000000000000000000000000000000000111111111111111111
1000111111111000000000000000000000010000000000000000000000000001111111111111111111111111111111110000011111111111111111
1000111111111110000000001000000000000000000001000000000000000011111111111111111111111111111111111000001111111111111111
10001111111111110000000000000000000100000000000000000000000001111111111111111111111111111111111111100001111111111111111
1000111111111111100000001000000000000000000001000000000000001111111111111111111111111111111111111111000011111111111111111
11000011111111111111111111111111111111111111111111111111111111111111111111111111111111111111111111110000011111111111111
110000111111111111111111111111111111111111111111111111111111111111111111111111111111111111111111111110000111111111111111
11000011111111111111111111111111111111111111111111111111111111111111111111111111111111111111111111111000011111111111111
11000011111111111111111111111111111111111111111111111111111111111111111111111111111111111111111111110000111111111111111
11100001111111111111111111111111111111111111111111111111111111111111111111111111111111111111111111100001111111111111111
11110000111111111111111111111111111111111111111111111111111111111111111111111111111111111111111111000011111111111111111
11111000011111111111111111111111111111111111111111111111111111111111111111111111111111111111111110000111111111111111111
11111100001111111111111111111111111111111111111111111111111111111111111111111111111111111111111100001111111111111111111
11111100001111111111111111111111111111111111111111111111111111111111111111111111111111111111111000011111111111111111111
11111000011111111111111111000000000111111111111111111111111111111111111111111111111111111111111000011111111111111111111
11111000011111111111111100000000000011111111111111111111111111111111111111111111111111111111111000011111111111111111111
11110000111111111111111000001111100001111111111111111111111111111111111111111111111111111111111100001111111111111111111
11100001111111111111100000111111110001111111111111111111111111111111111111111111111111111111111110000011111111111111111
11100001111111111111000011111111111000011111111111111111111111111111111111111111111111111111111111100001111111111111111
11110000111111111111000111111111111100001111111111111111111111111111111111111111111111111111111111110000111111111111111
1111100001111111111100001111111111110000111111111111111111111111111111111111111111111111111111111100000111111111111111
11111100000111111111000011111111111110000111111111111111111111111111111111111111110000000000000000000001111111111111111
1111111000000111111100001111111111111000011111111111111111111111111111111111111110000000000000000000001111111111111111
1111111110000000111000001111111111111000011111111111111111111111111111111111111110000111111111111111111111111111111111
1111111111100000000000111111111111111000011111111111111111111111111111111111111110000000000000000000111111111111111111
1111111111111000000001111111111111111000011111111111111111111111111111111111111111100000000000000000011111111111111111
1111111111111111111111111111111111111000011111111111111111111111111111111111111111111111111111111100001111111111111111
1111111111111111111111111111111111111000011111111111111111111111111111111111111111111111111111111111000111111111111111
1111111111111111111111111111111111111100001111111111111111111111111111111111111111111111111111111111100011111111111111
1111111111111111111111111111111111111110000111111111111111111111111111111111111111111111111111111111100011111111111111
1111111111111111111111111111111111111111000011111111111111111111111111111001111111111111111111111110000111111111111111
11111111111111111111111111111111111111111000011111111111111111111111111000000111111111111111111111000011111111111111111
1111111111111111111111111111111111111111110000011111111111111111111100000000000111111111111111111000011111111111111111
1111111111111111111111111111111111111111111100000111111111111111110000000110000011111111111111100000111111111111111111
1111111111111111111111111111111111111111111111000000000000000000000000011111100000000000000000000011111111111111111111
1111111111111111111111111111111111111111111111110000000000000000000011111111110000000000000000001111111111111111111111
1111111111111111111111111111111111111111111111111111111111111111111111111111111111111111111111111111111111111111111111
