  NO ./textures/semi_crafted_stone_wall.xpm
SO ./textures/league_wall.xpm
WE ./textures/dirt_stone.xpm
EA ./textures/stone_wall.xpm

F 205,250,250
C 250,250,250

11111111111111111111111111111111111111111111111111111111111
10S00000000000001100000000000000000001110000000000000111001
10000000100000000000000000000000001110000000000000000001101
11011111111111100000111100000000001100000001111100000000111
10001000010000011111100111000000011000000001100011000000011
10001101110000000000000001100000000000000110000011000000001
1000111100000000000000000110000000000001100000011000000001
10001101000000000000000000111111111111110000000111001010001
10001100000000000000000000000000000000000000000011000000001
10000100000000010000000000000000000000000000000011000000001
11100011110000010000000000000000000000000000000011000000001
11000011110111110000000000000011111110000000000010000001101
11000011000000000000000000001110000001000000000100000011001
11000000111111111111110000011000000000100000011000000110001
11000000000000000000011111100000011000011111110000001100001
10000000000000010000000000000001100000000000000000011000001
10000000000000010000000000000110000000000000000000110000001
11111111111111111111111111111111111111111111111111111111111