  NO ./textures/semi_crafted_stone_wall.xpm
SO ./textures/league_wall.xpm
WE ./textures/dirt_stone.xpm
EA ./textures/stone_wall.xpm

F 205,250,250
C 250,250,250

11111111111111111111111111111111111111111111111111111111111
10010000010000010000000000000000000000000000000000000000001
101100S0010000000000000000000000000000000000000000000000001
10010000010000000000000000000000000000000000000000000000001
10010000010000000000000000000000000000000000000000000000001
10010001110000000000000000000000000000000000000000000000001
10100011100000000000000000000000000000000000000000000000001
10100110100000000000000000000000000000000000000000000000001
11000100000000000000000000000000000000000000000000000000001
11001000000000010000000000000000000000000000000000000000001
11001011110000010000000000000000000000000000000000000000001
11000111110111110000000000000000000000000000000000000000001
1000000000000000000000000000000000000000000000000000000001
10000000000000010000000000000000000000000000000000000000001
11111111111111111111111111111111111111111111111111111111111