  NO ./textures/semi_crafted_stone_wall.xpm
SO ./textures/league_wall.xpm
WE ./textures/dirt_stone.xpm
EA ./textures/stone_wall.xpm

F 205,250,250
C 250,250,250

11111111111111111111111111111111111111111111111111111111111
10000000000000010000000000000000000000000000000000000000001
101000N0000000000000000000000000000000000000000000000000001
10000000000000000000000000000000000000000000000000000000001
10000000000000000000000000000000000000000000000000000000001
10000000000000000000000000000000000000000000000000000000001
10000000000000000000000000000000000000000000000000000000001
10000000000000000000000000000000000000000000000000000000001
10000000000000000000000000000000000000000000000000000000001
10000000000000010000000000000000000000000000000000000000001
10000011110000010000000000000000000000000000000000000000001
11101111110111110000000000000000000000000000000000000000001
10000000000000000000000000000000000000000000000000000000001
10000000000000010000000000000000000000000000000000000000001
11111111111111111111111111111111111111111111111111111111111